##########                   
#        #   #############   ######
#        #   #     #     #   #    #
#        #   #     #     #   #    #
#        #   #     #     #   #    #
#        #####     #     #####    #
#                                 #
############## ####### ############
             # #     # # ###
             # #     # # #N#
             # #     # # # #
        ###### ##  ### ### #
        #    #  #  #HHHHH  #
        #  ###  #  #HHHHH###
        #       #  #HHHHH#
        #########  #######